+-+--+--+--+--+--+--+
|g  +     f  H  G   |
| + + +--+ +--+ + + |
| | |    |    | | | |
| | +--+ +--+ + | + |
| f   H   f     |   |
| +--+--+--+ +--+   |
|    G     +      H |
+-+--+--+--+--+--+--+
