
--+--+--+--+--+--+
|g   |    H   |f|
|    +  +--+  + |
|  G |  |  |   ||
|  + +  +  +  + +
| f|   ?   |  H |
 +--+--+  +--+  +
|    G   |   f  |
|  +--+  +--+--+|
|  |   f   | G  |
|   H    |      |
--+--+--+--+--+--+
