+--+--+--+--+--+--+--+--+
|g    f                 |
+  +--+  +              +
|  |     |              |
+  +  +--+--            +
|  |   G                |
+  +--+--+              +
|   f    |              |
+--+--+--+--+--+--+--+--+
