+-+--+--+--+--+--+--+
|g  +     f  H  G   |
| + + +--+ +--+ + + |
| | |    |    | | | |
| | +--+ +--+ + | + |
| f       f     |   |
| +--+--+--+ +--+   |
|    G     +      H |
+-+--+--+--+--+--+--+
