+--+--+--+--+--+--+--+-+
|g               f     |
+  + +  +  +--+-----+  +
|  | |  |     |     | G|
+  + +  +--+  +  +  +  +
|    H|     |  |  G |  |
+--+--+  + H+--+  + +  +
|   f    |        |    |
+--+--+--+--+--+--+--+-+
