+--+--+--+--+
|g    f     |
+  +--+  +  +
|  |     | H|
+  +  +--+--+
|  |   G    |
+  +--+--+  +
|   f    |  |
+--+--+--+--+
