+--+--+--+--+--+--+--+--+
|g   +--+        f     |
+  + +  +  +--+-----+  +
|  | |  |     |     |  |
+  + +  +--+  +  +  +  +
|     |     |  |  G |  |
+--+--+  +  +--+  + +  +
|   f    |        |    |
+--+--+--+--+--+--+--+--+
