+--+--+--+--+--+--+
|   f   H  |     |
+  +--+  + +  +  +
|  |  G  | |  |  |
+  +  +--+ +--+  +
|     |   H    f |
+--+--+--+--+--+--+
