
+-+--+--+--+--+---+
|g              f |
|   +--+  +--+    |
|   |  |  |  | g  |
|   +  |  +  |    |
|  G    H    G    |
|      f          |
+-+--+--+--+--+---+
