+--+--+--+--+--+--+
|   f      |     |
+  +--+  + +  +  +
|  |  G  | |  |  |
+  +  +--+ +--+  +
|     |        f |
+--+--+--+--+--+--+
